##########
#G  O# X #
# #   #  #
# # #    #
#        #
#    ### #
#O   #G  #
# ##    O#
#G # #   #
##########