##########
#G  O#   #
# ## #  X#
#    #   #
# ##   G #
#   #O   #
# ### #  #
#  G  #O #
#    #   #
##########