##########
#O  # G  #
# # #    #
# #  ##  #
#  X     #
#    ## G#
#   #O   #
# ## #   #
#G   #   #
##########